111111111111111111
1E0000000000000C01
100001010010000000
100001001010101001
1P0000000C00C00001
111111111111111111